

SO                  ./path_to_the_south_texture
NO            ./path_to_the_north_texture
F   225,30,115
WE        ./path_to_the_west_texture
EA   ./path_to_the_east_texture
C         250,100,0

111111111111111111111111111111111
111011110000000001100000000000011
111111111011000001110000000000001
111111111001000000000000000000001
111111111011000001110000000000001
100000000011000001110111111111111
111111110111111111011100000010001
111111110111111111111101010010001
111111000000110101011100000010001
100000000000000011000000100011111
100000000000000011010100100011111
11000001110101011111011110S011111
111101111111010111011110100011111
111111111111111111111111111111111
